OOOOOOOOOO##########
OOOOOOOOOOO#########
OOOOOOOOOOOOOOOO####
OOOOOO###OOOOOOOOO##
OOOOO####OOOOOOOOOO#
OO#####OOOOOOOOOOOO#
O#####OOOOO##OOOOOO#
O###OOOOOO#####OOOO#
O##OOOOOOO#####OOO##
###OOOOOOOO###OOO###
###OOOOOOOOO##OOO###
OOOOOOOOOOOOOOOOO###
OOOOOOXXOOOOOOOOOO##
OOOOOXXXXXOOOOOOOO##
OOOOXXXXXXXOOOOOOOO#
OOOOXXXXXXXOOOOOOOO#
OOOOOXXXXXXXOOOOOOOO
OOOOOOOXXXOOOOOOXOOO
OOOOOOOOOOOOOOOOOOOO
OOOOOOOOOOOOOOOOOOOO