OOOOOOOOOOOOOOOOOOOO
OOOOOOOOOOOOOOOXXOOO
OOOOOOOOOOOOOOXXXXOO
OOOOOOOOOOOOOXXOOXOO
OOOOOOOOOOOOXXOOOXXO
OOOOOOOOOOOOXXOOOXXO
OOOOOOOOOOOOOXXXXXOO
OOOOXXOOOOOOOOXXXOOO
OOOXXXXOOOOOOOOOOOOO
OOXXXXXOOOOOOOOOOOOO
OXXXXXOOOOOOOOOOOOOO
OOXXOOOOOOOOOOOOOOOO
OOOXOOOOOOOOOOOOOOOO
OOOOOOOOOOOOXXOOOOOO
OOOOOOOOOOXXXXXXOOOO
OOOOOOOOOXXXXXXXOOOO
OOOOOOOOOOXXXXXXXOOO
OOOOOOOOOOOXXOOXOOOO
OOOOOOOOOOOOOOOOOOOO
OOOOOOOOOOOOOOOOOOOO
